############################
#...........................#
#..........................E#
#.K.......................###
#.......................#...#
#.....###.........###.......#
#..P........................#
#............#........#.....#
############################