############################
#..........................#
#.....................E....#
#..........................#
#..K.......................#
#..............###.........#
#....###...................#
#..P........###............#
#..........................#
############################