############################################################
#........................................................E.#
#........................................#######...........#
#..............................######......................#
#....................#######.........................#####.#
#.............#####...........K.......#.......######.......#
#.....######......#.........#.........######...............#
#.P...............#.........#..............................#
############################################################