############################
#..........................#
#.............###..........#
#...............#..........#
#..P..........#K#..........#
#.............###.......E..#
#.........###..............#
#..........................#
############################