############################
#..........................#
#..........................#
#.....................E....#
#........####...##.........#
#..........................#
#.####.....................#
#..........................#
#........#####.............#
#..........................#
#.................###......#
#..........................#
#........................###
#..........................#
#..................###.....#
#..........................#
#............###...........#
#..........K...............#
#.....###..................#
#..P........###............#
#..........................#
############################