############################
#........................E.#
#..................###.....#
#.............###..........#
#......###.................#
#..................###.....#
#..P........K..............#
#...............###........#
############################