############################
#..........................#
#..........................#
#..........................#
#..........................#
#.....P....................#
#..........................#
#.............K...........E#
############################