############################
#..........................#
#..........................#
#..........................#
#...........K..............#
#..........................#
#..P.......###...........E.#
#..........................#
############################