############################
#..........................#
#..........................#
#.........................E#
#.................##########
#.........###..............#
#..................K.......#
#...............####.......#
#..P.......................#
#.......................####
############################