############################
#.....................E.....#
#..............###..........#
#.....K.....................#
#.....###.........###.......#
#..P........................#
#............#...........#..#
############################